#漢字N５　2章　カレンダー　1/2
月=つき
月曜日=げつ・よう・び
今月=こん・げつ
九月=く・がつ
一か月=いっ・か・げつ
火=ひ
火曜日=か・よう・び
水=みず
水曜日=すい・よう・び
水泳=すい・えい
香水=こう・すい
木=き
大木=たい・ぼく
木曜日=もく・よう・び
お金=お・かね
料金=りょう・きん
#漢字N５　2章　カレンダー　2/2
現金=げん・きん
金=きん
金曜日=きん・よう・び
土=つち
土曜日=ど・よう・び
日=ひ
日曜日=にち・よう・び
七月七日=しち・がつ・しち・にち
七月七日=しち・がつ・しち・にち
生年月日=せん・ねん・がっ・ぴ
年=とし
毎年=まい・とし
2年前=に・ねん・まえ
去年=きょ・ねん
２０１３年=２０１３ねん
休日=きゅう・じつ
誕生日=たん・じょう・び
六日=むい・か