#形容詞
高い=たかい
寒い=さむい
新しい=あたらしい
大きい=
面白い
楽しい=たのしい
忙しい=いそがしい
いい
汚い=きたない
熱い=あつい
難しい=むずかしい
高い=たかい
美味しい=おいしい
若い=わかい
青い=あおい
赤い=あかい
白い=しろい
黒い=くろい
緑色=みどりいろ
黄色い=きいろい
多い=おおい
短い=みじか・い
格好いい=かっ・こ・いい
寂しい=さび・しい
嬉しい=うれ・しい
頭いい=あたま・いい
可愛い=かわいい
速い=はや・い
早い=はや・い
重い=おも・い
広い=ひろ・い
太い=ふと・い
遠い=とお・い
明るい=あか・るい
辛い=から・い
甘い=あま・い
危ない=あぶ・ない
強い=つよ・い
太い=ふと・い
低い=ひくい
暑い=あつい
古い=ふるい
小さい
詰まらない=つまらない
悪い=わるい
冷たい=つめたい
易しい=やさしい
安い=やすい
不味い=まずい
少ない=すくない
長い=なが・い
格好悪い=かっ・こ・わる・い
悲しい=かな・しい
頭悪い=あたま・わるい
ゆっくり
遅い=おそ・い
軽い=かるい
狭い=せまい
薄い=うす・い
近い=ちか・い
暗い=くら・い
弱い=よわ・い
細い=ほそ・い
きれい
賑やか=にぎやか
有名
便利=べんり
ハンサム
親切=しんせつ
暇=ひま
素敵=すてき
元気=げんき
大切な=たい・せつ・な
簡単=かん・たん
下手な=へたな
丈夫な=じょう・ぶ・な
安全な=あん・ぜん・な
立派な=りっぱな
静か=しずか
