窓 = まど
閉まる = しまる
電車 = でん・しゃ
傘 = かさ
忘れる = わすれる
しまう
会議室 = かい・ぎ・しつ
かぎ
掛かる = かかる
言う = いう
開ける = あける
もらう
パソコン
故障 = こ・しょう
あちら
持って来た = もって・きた
みんな
一緒に = いっしょに
帰る = かえ・る
お先に = どうぞ
約束 = やく・そく
間に合う = まに・あう
遅れる = おくれる
道 = みち
間違える = まちが・える
荷物 = に・もつ
忘れ物 = わすれ・もの
青い = あおい
かばん
外側 = そと・がわ
大きい = おお・きい
ポケット
付いて = います = ついています
どの辺 = どのへん
置く = おく
覚える = おぼえる
網棚 = あみだな
上 = うえ
中に = なかに
入っています = はいっています
確か = たしか
調べる = しらべる
取る = とる
事務所 = じむしょ
ドア
ガラス
割れる = われる
袋 = ふくろ
破れる = やぶれる
折れる = おれる
全部 = ぜんぶ
宿題 = しゅく・だい
レポート
今晩 = こん・ばん
金曜日 = きん・よう・び
までに
財布 = さい・ふ
落とす = おとす
電話番号 = でん・わ・ばん・ご
間違える = まち・が・える
壊れる = こわ・れる
汚れる = よごれる
エアコンをつける
エアコンを消しる
テーブルを拭く（ふく）
時計（とけい）が止まります（とまります）
電池を（でんちを）取る替える（とりかえる）
洗濯機（せんたくき）壊れる（こわれる）
手で（てで）洗う（あらう）
スーパーが閉まる（しまる）
コンビニで買いましょう（かいましょう）
夏休み = なつ・やす・み
覚える = おぼえる
そろそろ帰る（かえる）
メールの返事（へんじ）を書きます（かきます）
資料（しりょう）を作ります（つくります）
仕事（しごと）をやります
出張（しゅっちょう）の準備（じゅんび）をします
住所（じゅうしょ）を聞きます（ききます）
忘れて（わすれて）しまいました
駅（えき）まで走ります（はしります）
約束（やくそく）の時間（じかん）に遅れました（おくれました）
気（き）をつけていました
カードをなくしました
地図（ちず）を見ながら行きました
かばんが開いています（あいています）
ボタンが外れます（はずれます）
封筒（ふうとう）が汚れています（よごれています）
財布（さいふ）を落とす（おとす）
大変 = たいへん
交番（こうばん）に行く
どこかで
カード会社（かいしゃ）に連絡する（れんらくする）
書類（しょるい）を忘れます（わすれます）
駅員（えき・いん）に言います（いいます）
切符（きっぷ）を買います
行き方（いきかた）を教える（おしえる）
地震（じしん）がありました
建物（たてもの）が壊れる（こわれる）
電車（でんしゃ）は動いていません
音楽 = おんがく = music
聞く = きく = to hear; to listen; to ask
食事 = しょくじ = meal; dinner​
毎朝 = まいあさ = every morning​
ジョギング = jogging​
地下鉄 = ちかてつ = subway
速い = はやい = fast; quick; early
安い = やすい = cheap; inexpensive​
行く = いく = to go
眠い = ねむい = sleepy
時 = とき
ガム
嚙む = かむ
運転する = うんてんする
止める = とめる
しばらく
寝る = ねる
勉強する = べんきょうする
彼 = かれ
働く = はたらく
大学 = だいがく
偉い = えらい
休み = やすみ
日 = ひ
いつも
何 = なに
たいてい
絵 = え
描く = かく
熱心 = ねっしん
面白い = おもしろい
経験 = けいけん
先生 = せんせい
よく
寿司屋 = すしや
来る = くる
値段 = ねだん
魚 = さかな
新しい = あたらしい
どうして
選ぶ = えらぶ
有名 = ゆうめい
多い = おおい
寮 = りょう
出張 = しゅっちょう
ちょっと
お願い = おねがい
実は = じつは
それで
友達 = ともだち
英語 = えいご
なかなか
上手 = じょうず
なる
話す = はなす
チャンス
会話 = かいわ
頂く = いただく
仕事 = しごと
暇な時 = ひまなとき
お茶 = おちゃ
飲む = のむ
もうすぐ
試験 = しけん
写真 = しゃしん
見せる = みせる
説明する = せつめいする
話 = はなし
教える = おしえる
研究 = けんきゅう
息子 = むすこ
釣り = つり
娘 = むすめ
買い物 = かいもの
映画 = えいが
見る = みる
ピアノ
弾ける = ひける
歌 = うた
歌える = うたえる
ダンス
出来る = できる
力 = ちから
強い = つよい
店(みせ)
静か = しずか
広い = ひろい
味 = あじ
素敵 = すてき
綺麗 = きれい
夢 = ゆめ
歩く = あるく
話す = はなす
電話 = でんわ
世界 = せかい
旅行 = りょこう
暇な時 = ひまなとき
パソコン
毎晩 = まいばん
どんな
番組 = ばんぐみ
子供 = こども
遊び = あそぶ
学校 = がっこう
通う = かよう
自転車 = じてんしゃ
毎朝 = まいあさ
電車 = でんしゃ
中 = なか
掃除機 = そうじき
小さい = ちいさい
軽い = かるい
音 = おと
北海道 = ほっかいどう
涼しい = すずしい
景色 = けしき
食べ物 = たべもの
美容院 = びよういん
台所 = だいどころ
便利 = べんり
形 = かたち
色 = いろ
高い = たかい
熱 = ねつ
頭 = あたま
痛い = いたい
会社 = かいしゃ
品物 = しなもの
明日 = あした
用事 = ようじ
うち
ゆっくり
ちょうど
靴 = くつ
買う = かう
マンション
素晴らしい = すばらしい
ペット
飼える = かえる
売れる = うれる
歌手 = かしゅ
若い = わかい
人気 = にんき
声 = こえ
田舎 = いなか
住みたい = すみたい
緑 = みどり
なりたい
大切な = たいせつな
思う = おもう
辞める = やめる
給料 = きゅうりょう
少ない = すくない
電気 = でんき
製品 = せいひん
故障 = こしょう
将来 = しょうらい
夢 = ゆめ
いつか
作る = つくる
働く = はたらく
夜 = よる
頑張って = がんばって
小説家 = しょうせつか
小説 = しょうせつ
自分 = じぶん
持つ = もつ
料理 = りょうり
ずいぶん
人 = ひと
コーヒー
サービス
これから
一緒に = いっしょに
昨日 = きのう
大阪 = おおさか
遅い = おそい
体 = からだ
調子 = ちょうし
日曜日 = にちようび
寝る = ねる
起きる = おきる
乗る = のる
泳ぐ = およぐ
雨 = あめ
駅 = えき
パン
プール
今朝 = けさ
悪い = わるい
学生 = がくせい
交通 = こうつう
今日 = きょう
天気 = てんき
お金 = おかね
一緒に = いっしょに
色々な = いろいろな
国 = くに
プレゼント
皆さん = みなさん
ぜひ
参加する = さんかする
日にち = ひにち
午後 = ごご
場所 = ばしょ
体育館 = たいいくかん
無料 = むりょう
誘う = さそう
留学生 = りゅうがくせい
作れる = つくれる
払う = はらう
イベント
花見 = はなみ
運動会 = うんどうかい
お知られ = おしらせ
特に = とくに
特売 = とくばい
特急 = とっきゅう
今日 = きょう
特別 = とくべつ
始める = はじめる
思う = おもう
思い出 = おもいで
思い = おもい
思春期 = ししゅんき
自分 = じぶん
意思 = いし
留学 = りゅうがく
決める = きめる
料金 = りょうきん
無料 = むりょう
資料 = しりょう
理由 = りゆう
物理 = ぶつり
先に = さきに
食料 = しょくりょう
買う = かう
給料 = きゅうりょう
妻 = つま
作る = つくる
料理 = りょうり
私 = わたし
理系 = りけい
国立大学 = こくりつだいがく
入りたい = はいりたい
有名 = ゆうめい
有名人 = ゆうめいじん
彼女 = かのじょ
有力な = ゆうりょくな
情報 = じょうほう
有料 = ゆうりょう
駐車場 = ちゅうしゃじょう
有利 = ゆうり
週末 = しゅうまつ
夫 = おっと
二人 = ふたり
夫婦 = ふうふ
今年 = ことし
愛妻家 = あいさいか
電車 = でんしゃ
思い出します = おもいだします
婦人 = ふじん
専門学校 = せん・もん・がっ・こう
西洋料理 = せい・よう・りょい・り
彼女 = かの・じょ
洋楽 = よう・がく
今度 = こん・ど
洋服 = よう・ふく
買います = かいます
一度 = いち・ど
和服 = わ・ふく
制服 = せい・ふく
西洋 = せい・よう
東洋 = とう・よう
洋画 = よう・が
私服 = し・ふく
衣食住 = い・しょく・じゅ
人 = ひと
生活 = せい・かつ
必要 = ひつ・よう
衣服 = い・ふく
十月 = じゅう・がつ
衣替え = ころも・がえ
短い = みじかい
時間 = じ・かん
木村 = き・むら
短気 = たん・き
衣料品 = い・りょう・ひん
短所 = たん・しょ
長短 = ちょう・たん
髪の毛 = かみ・の・け
短く = みじかく
切る = きる
眉毛 = まゆ・げ
毛布 = もう・ふ
一枚 = いち・まい
毛糸 = けい・と
作る = つくる
糸くず = いと・くず
羊毛 = よう・もう
まつ毛 = まつ・げ
犬の毛 = いぬ・の・け
針と糸 = はり・と・いと
水玉模様 = みず・たま・もう・よう
子どもの頃 = こども・の・ころ
お手玉 = お・て・だま
光る = ひかる
光 = ひかり
電気 = でん・き
作ります = つくります
日光 = にっ・こう
日本 = に・ほん
有名な = ゆう・めい・な
観光地 = かん・こう・ち
玉葱 = たま・ねぎ
月 = つき
十円玉 = じゅう・えん・だま
電光掲示板 = でん・こう・けい・じ・ばん
