#単語 1
符号=ふごう=symbol
数=かず=nummer
表す=あらわす=betyder/visar
気温=きおん=temperatur
基準=きじゅん=standard
正の符号=せいのふごう=plus symbol
負の符号=ふのふごう=minus symbol
正の数=せいのすう=plus siffra
負の数=ふのすう=minus siffra
整数=せいすう=heltal
正の整数=せいのせいすう=plus heltal
負の整数=ふのせいすう=minus heltal

#単語 2
自然数=しぜんすう=plus heltal
負の小数=ふのしょうすう=minus decimaltal
負の分数=ふのふんすう=minus devision
量=りょう=mängd
海面=かいめん=havsytan
高さ=たかさ=height
標高=ひょうこう=elevation
地点=ちてん=plats/ spot
表=ひょうこう=grafik
増える=ふえる=ökar
減る=へる=minskar
平年値=へいねんち=genomsnittligt värde
水深=すいしん=vattnets djup

#単語 3
大小=だいしょう=storlek
数直線=すうちょくせん=tallinje
点=てん=spot
直線=ちょくせん=raka linje
一定の=いっていの=en viss
間隔=かんかく=avstånd
原点=げんてん=starting point
方向=ほうこう=direction
正の方向=せいのほうこう=plus direction
負の方向=ふのほうこう=minus direction
範囲=はんい=räckvidd
各組=かくくみ=varje grupp

#単語 4
不等号=ふとうごう=ojämlikhetstecken
直す=なおす=rätta till
絶対値=ぜったいち=absolut värde
距離=きょり=distans
等しい=ひとしい=samma
対応する=たいおうする=motsvarar
基本=きほん=grundläggande
問題=もんだい=problem
答える=こたえる=svara
反対=はんたい=tvärtom
性質=せいしつ=natur
解答=かいとう=answer
不足=ふそく=brist
超過=ちょうか=överskott